050 050
114,000 114,000 114,000 114,000 114,000 114,000 114,000 114,000 114,000 114,000 114,000 114,000 114,000 114,000 114,000 114,000 114,000 114,000 114,000 114,000 093,000 104,000 104,000 098,000 114,000 114,000 114,000 114,000 114,000 114,000 114,000 114,000 114,000 114,000 114,000 114,000 114,000 114,000 114,000 114,000 114,000 114,000 114,000 114,000 114,000 114,000 114,000 114,000 114,000 114,000
114,000 114,000 114,000 114,000 114,000 114,000 114,000 114,000 114,000 114,000 114,000 114,000 114,000 114,000 114,000 114,000 114,000 114,000 114,026 114,000 093,000 104,000 104,000 098,000 114,000 114,026 114,000 114,000 114,000 114,000 114,000 114,000 114,000 114,000 114,000 114,000 114,000 114,000 114,000 114,000 114,000 114,000 114,000 114,000 114,000 114,000 150,000 151,000 114,000 114,000
114,000 114,000 114,000 114,033 114,033 114,000 114,000 114,000 114,000 114,000 114,000 114,000 114,000 114,000 114,000 114,000 114,000 114,000 114,000 114,000 093,000 104,000 148,000 098,000 114,000 114,000 114,000 114,000 114,000 114,000 114,000 114,000 114,000 114,000 114,000 114,000 114,000 114,000 114,000 114,000 114,000 114,000 114,000 114,000 114,000 114,000 152,000 153,000 114,000 114,000
114,000 114,000 114,033 114,033 114,033 114,000 114,000 114,000 114,000 114,000 114,000 114,000 114,000 114,000 114,000 114,000 114,000 114,000 114,250 114,000 093,000 104,000 104,000 098,000 114,000 114,250 114,000 114,000 114,000 114,000 114,000 114,000 114,000 114,000 114,000 114,000 114,000 114,000 114,000 114,000 114,000 114,000 114,000 114,000 114,000 114,000 114,000 114,000 114,000 114,000
114,000 114,000 114,033 114,033 114,033 114,000 114,000 114,000 114,000 114,000 114,000 114,000 114,000 114,000 114,000 114,000 114,000 114,000 114,000 091,000 099,000 104,000 104,000 100,000 094,000 114,000 114,000 114,000 114,000 114,000 114,000 114,000 114,000 114,000 114,000 114,000 114,000 114,000 114,000 114,000 114,000 114,000 114,000 114,000 114,000 114,000 114,000 114,000 114,000 114,000
095,000 095,000 095,000 095,033 095,000 095,000 095,000 095,000 095,000 095,000 095,000 095,000 094,000 091,000 095,000 095,000 095,000 095,000 095,000 099,000 104,000 104,000 104,000 104,000 100,000 095,000 095,000 095,000 095,000 095,000 095,000 095,000 095,000 095,000 095,000 095,000 095,000 095,000 095,000 095,000 094,000 114,000 114,000 114,000 091,000 095,000 095,000 095,000 095,000 095,000
104,000 104,000 104,000 104,000 103,000 104,000 104,000 104,000 104,000 104,000 104,000 104,000 100,000 099,000 104,000 104,000	104,000	104,000	104,000	104,000	104,000	104,000	104,000	104,000	104,000	104,000	104,000	104,000	104,000	104,000	104,000 104,000 104,000	104,000	104,000	104,000	104,000	104,000	104,000	104,000	100,000	095,000	095,000	095,000	099,000	104,000	104,000	104,000	104,000	104,000
104,000 104,000 104,000 104,000 104,000 104,000 104,000 104,000 147,000 104,000 104,000 104,000 104,000 104,000 104,000 104,000 104,000 104,000 104,000 104,000 104,000 104,000 104,000 104,000 104,000 104,000 104,000 104,000 104,000 104,000 104,000 104,000 104,000 104,000 104,000 104,000 104,000 104,000 104,000 104,000 104,000 104,000 104,000 104,000 104,000 104,000 104,000 155,000 104,000 104,000
096,000 096,000 096,000 096,000 096,000 096,000 096,000 096,000 096,000 096,000 096,000 096,000 096,000 096,000 096,000 096,000 096,000 096,000 096,026 101,000 104,000 104,000 104,000 104,000 102,000 096,025 096,000 096,000 096,000 096,000 096,000 096,000 096,000 096,000 096,000 096,000 096,000 096,000 096,000 096,000 096,000 096,000 096,000 096,000 096,000 096,000 096,000 096,000 096,000 096,000
114,000 114,000 114,000 114,000 114,000 114,000 114,000 114,000 114,000 114,000 114,000 114,000 114,000 114,000 114,000 114,000 114,000 114,000 114,000 092,000 101,000 104,000 104,000 102,000 097,000 114,000 114,000 114,000 114,000 114,000 114,000 114,000 114,000 114,000 114,000 114,000 114,000 114,000 114,000 114,000 114,000 114,000 114,000 114,000 114,000 114,000 114,000 114,000 114,000 114,000
114,000 114,000 114,000 114,000 114,000 114,000 114,000 114,000 114,000 114,000 114,000 114,000 114,000 114,000 114,000 114,000 114,000 114,000 114,250 114,000 093,000 104,000 104,000 098,000 114,000 114,250 114,000 114,000 114,000 114,000 114,000 114,000 114,000 114,000 114,000 114,000 114,000 114,000 114,000 114,000 114,000 114,000 114,000 114,000 114,000 114,000 114,000 114,000 114,000 114,000
114,000 114,000 114,000 114,000 114,000 114,000 114,000 114,000 114,000 114,000 114,000 114,000 114,000 114,000 114,000 114,000 114,000 114,000 114,000 114,000 093,000 104,000 104,000 098,000 114,000 114,000 114,000 114,000 114,000 114,000 114,000 114,000 114,000 114,000 114,000 114,000 114,000 114,000 114,000 114,000 114,000 114,000 114,000 114,000 114,000 114,000 114,000 114,000 114,000 114,000
114,000 114,000 114,000 114,000 114,000 114,000 114,000 114,000 114,000 114,000 114,000 114,000 114,000 114,000 114,000 114,000 114,000 114,000 114,000 114,000 093,000 104,000 104,000 098,000 114,000 114,000 114,000 114,000 114,000 114,000 114,000 114,000 114,000 114,000 114,000 114,000 114,000 114,000 114,000 114,000 114,000 114,000 114,000 114,000 114,000 114,000 114,000 114,000 114,000 114,000
114,000 114,000 114,000 114,000 114,000 114,000 114,000 114,000 114,000 114,000 114,000 114,000 114,000 114,000 114,000 114,000 114,000 114,000 114,000 114,000 093,000 104,000 104,000 098,000 114,000 114,000 114,000 114,000 114,000 114,000 114,000 114,000 114,000 114,000 114,000 114,000 114,000 114,000 114,000 114,000 114,000 114,000 114,000 114,000 114,000 114,000 114,000 114,000 114,000 114,000
114,000 114,000 114,000 114,000 114,000 114,000 114,000 114,000 114,000 114,000 114,000 114,000 114,000 114,000 114,000 114,000 114,000 114,000 114,000 114,000 093,000 104,000 104,000 098,000 114,000 114,000 114,000 114,000 114,000 114,000 114,000 114,000 114,000 114,000 114,000 114,000 114,000 114,000 114,000 114,000 114,000 114,000 114,000 114,000 114,000 114,000 114,000 114,000 114,000 114,000
114,000 114,000 114,000 114,000 114,000 114,000 114,000 150,000 151,000 114,000 114,000 114,000 114,000 114,000 114,000 114,000 114,000 114,000 114,000 114,000 093,000 104,000 104,000 098,000 114,000 114,000 114,000 114,000 114,000 114,000 114,000 114,000 114,000 114,000 114,000 114,000 114,000 114,000 114,000 114,000 114,000 114,000 114,000 114,000 114,000 114,000 114,000 114,000 114,000 114,000
114,000 114,000 114,000 114,000 114,000 114,000 114,000 152,000 153,000 114,000 114,000 114,000 114,000 114,000 114,000 114,000 114,000 114,000 114,000 114,000 093,000 104,000 104,000 098,000 114,000 114,000 114,000 114,000 114,000 114,000 114,000 114,000 114,000 114,000 114,000 114,000 114,000 114,000 114,000 114,000 114,000 114,000 114,000 114,000 114,000 114,000 114,000 114,000 114,000 114,000
114,000 114,000 114,000 114,000 114,000 114,000 114,000 114,000 114,000 114,000 114,000 114,000 114,000 114,000 114,000 114,000 114,000 114,000 114,000 114,000 093,000 104,000 104,000 098,000 114,000 114,000 114,000 114,000 114,000 114,000 114,000 114,000 114,000 114,000 114,000 114,000 114,000 114,000 114,000 114,000 114,000 114,000 114,000 114,000 114,000 114,000 114,000 114,000 114,000 114,000
114,000 114,000 114,000 114,107 114,108 114,000 114,000 114,107 114,125 114,000 114,000 114,000 114,000 114,000 114,000 114,000 114,000 114,000 114,000 114,000 093,000 104,000 104,000 098,000 114,000 114,000 114,000 114,000 114,000 114,000 114,000 114,000 114,000 114,000 114,000 114,000 114,000 114,000 114,000 114,000 114,000 114,000 114,000 114,000 114,000 114,000 114,000 114,000 114,000 114,000
114,000 114,000 114,109 114,110 114,111 114,112 114,109 114,110 114,111 114,112 114,063 114,000 114,000 114,000 114,000 114,000 114,000 114,000 114,000 114,000 093,000 104,000 104,000 098,000 114,000 114,000 114,000 114,000 114,000 114,000 114,000 114,000 114,000 114,000 114,000 114,000 114,000 114,000 114,000 114,000 114,000 114,000 114,000 114,000 114,000 114,000 114,000 114,000 114,000 114,000
114,000 114,000 114,113 114,114 114,115 114,116 114,113 114,114 114,115 114,116 114,063 114,000 114,000 114,000 114,000 114,000 114,000 114,000 114,000 114,000 093,000 149,000 104,000 098,000 114,000 114,000 114,000 114,000 114,000 114,000 114,000 114,000 114,000 114,000 114,000 114,000 114,000 114,000 114,000 114,000 114,000 114,000 114,000 114,000 150,000 151,000 124,250 140,250 140,250 140,250
114,000 114,000 114,117 114,118 114,119 114,120 114,117 114,118 114,119 114,120 114,043 114,000 114,000 114,000 114,000 114,000 114,000 114,000 114,000 114,084 093,000 103,000 104,000 098,000 114,000 114,000 114,000 114,000 114,000 114,000 114,000 114,000 114,000 114,000 114,000 114,000 114,000 114,000 114,000 114,000 114,000 114,000 114,000 114,000 152,000 153,000 142,250 129,250 129,250 129,250
114,000 114,000 114,121 114,122 114,123 114,124 114,121 114,122 114,123 114,124 114,000 114,000 114,000 114,000 114,000 114,000 114,000 114,000 114,000 114,000 093,000 104,000 104,000 098,000 124,250 140,250 140,250 140,250 140,250 140,250 140,250 140,250 140,250 140,250 140,250 140,250 140,250 125,250 114,000 114,000 114,000 114,000 114,000 114,000 114,000 114,000 142,250 129,250 129,250 129,250
114,000 114,000 114,000 114,000 114,000 114,000 114,000 114,000 114,000 114,000 114,000 114,000 114,000 114,000 114,000 114,000 114,000 114,000 114,000 091,000 099,000 104,000 104,000 098,000 142,250 129,000 129,250 129,250 129,250 129,250 129,250 129,250 129,250 129,250 129,250 129,250 129,250 141,250 114,000 114,000 114,000 114,104 114,000 114,000 114,000 114,000 142,250 129,250 129,250 129,250
114,000 114,000 114,000 114,000 114,000 114,000 114,000 114,000 114,018 114,000 114,000 114,000 114,000 114,000 114,000 114,000 114,000 114,000 091,000 099,000 104,000 104,000 104,000 098,000 142,250 129,250 129,250 129,250 129,250 129,250 129,250 129,250 129,250 129,250 129,250 129,250 129,250 141,250 114,105 114,000 114,000 114,250 114,250 114,000 114,000 114,105 142,250 129,250 129,250 129,250
114,000 114,000 114,000 114,000 114,000 114,019 114,000 114,000 114,000 114,000 114,000 114,000 114,000 091,000 095,000 095,000 095,000 095,000 099,000 104,000 104,000 104,046 104,000 098,000 142,250 129,250 129,250 129,250 129,250 129,250 129,250 129,250 129,250 129,250 129,250 129,250 129,250 141,250 114,000 114,000 114,000 114,000 114,000 114,000 114,000 114,000 142,250 129,250 129,250 129,250
114,000 114,000 114,000 114,000 114,000 114,000 114,000 114,000 114,000 114,000 114,000 114,000 114,000 093,000 104,000 104,000 104,000 104,000 104,000 104,000 104,000 104,250 104,000 098,000 142,250 129,250 129,250 129,250 129,250 129,250 129,250 129,250 129,250 129,250 129,250 129,250 129,250 141,250 114,250 114,000 114,000 114,000 114,000 114,000 114,000 114,250 142,250 129,250 129,250 129,250
114,000 114,000 114,000 114,000 114,000 114,000 114,000 114,000 114,000 114,000 114,000 114,000 091,000 099,000 104,000 104,000 104,000 104,000 104,000 104,000 104,000 104,000 104,000 098,000 142,250 129,250 129,250 129,250 129,250 129,250 129,250 129,250 129,250 129,250 129,250 129,250 129,250 146,250 140,250 140,250 140,250 140,250 140,250 140,250 140,250 140,250 145,250 129,250 129,250 129,250
114,000 114,000 114,000 114,000 114,000 114,000 114,000 114,000 114,000 114,000 114,000 114,000 093,000 104,000 104,000 104,000 104,000 104,000 104,000 104,000 104,000 104,000 104,000 098,000 142,250 129,250 129,250 129,250 129,250 129,250 129,250 129,250 129,250 129,250 129,250 129,250 129,250 129,250 129,250 129,250 129,250 129,250 129,250 129,250 129,250 129,250 129,250 129,250 129,250 129,250
114,000 114,000 114,000 114,000 114,000 114,000 114,000 114,000 114,000 114,000 114,000 114,000 093,000 104,000 104,000 104,000 104,000 104,000 104,000 104,000 104,000 104,000 104,000 098,000 142,250 129,250 129,250 129,250 129,250 129,250 129,250 129,250 129,250 129,250 129,250 129,250 129,250 129,250 129,250 129,250 129,250 129,250 129,250 129,250 129,250 129,250 129,250 129,250 129,250 129,250
114,000 114,000 114,000 114,000 114,000 114,000 114,000 114,000 114,000 114,000 114,000 114,000 092,000 096,000 096,000 101,000 104,000 147,000 104,000 104,000 104,000 104,000 104,000 098,000 142,250 129,250 129,250 129,250 129,250 129,250 129,250 129,250 129,250 129,250 129,250 129,250 129,250 129,250 129,250 129,250 129,250 129,250 129,250 129,250 129,250 129,250 129,250 129,250 129,250 129,250
114,000 091,000 095,000 094,000 114,000 114,000 114,000 114,000 091,000 095,000 094,000 114,000 114,000 114,000 114,000 093,000 104,000 104,000 104,000 104,000 104,000 104,000 148,000 098,000 142,250 129,250 129,250 129,250 129,250 129,250 129,250 129,250 129,250 129,250 129,250 129,250 129,250 129,250 129,250 129,250 129,250 129,250 129,250 129,250 129,250 129,250 129,250 129,250 129,250 129,250
091,000 099,000 104,000 100,000 094,000 114,000 114,000 091,000 099,000 104,000 100,000 094,000 114,000 114,000 114,000 093,000 104,000 104,000 104,000 104,000 104,000 104,000 104,000 098,000 142,250 129,250 129,250 129,250 129,250 129,250 129,250 129,250 129,250 129,250 129,250 129,250 129,250 129,250 129,250 129,250 129,250 129,250 129,250 129,250 129,250 129,250 129,250 129,250 129,250 129,250
093,000 104,000 104,000 104,000 098,000 114,000 114,000 093,000 104,000 104,000 104,000 098,000 114,000 114,000 114,000 093,000 104,000 104,000 104,000 104,000 104,000 104,000 104,000 098,000 142,250 129,250 129,250 129,250 129,250 129,250 129,250 129,250 129,250 129,250 129,250 129,250 129,250 129,250 129,250 129,250 129,250 129,250 129,250 129,250 129,250 129,250 129,250 129,250 129,250 129,250
092,000 101,000 104,000 102,000 097,000 114,000 114,000 092,000 101,000 104,000 102,000 097,000 114,000 114,000 114,000 093,000 104,000 104,000 104,000 104,000 104,000 104,000 104,000 098,000 142,250 129,250 129,250 129,250 129,250 129,250 129,250 129,250 129,250 129,250 129,250 129,250 129,250 129,250 129,250 129,250 129,250 129,250 129,250 129,250 129,250 129,250 129,250 129,250 129,250 129,250
114,000 092,000 096,000 097,000 114,000 091,000 094,000 114,000 092,000 096,000 097,000 114,000 114,000 114,000 114,000 093,000 104,000 104,000 104,000 104,000 104,000 104,000 104,000 098,000 142,250 129,250 129,250 129,250 129,250 129,250 129,250 129,250 129,250 129,250 129,082 129,250 129,250 129,250 129,250 129,250 129,250 129,250 129,250 129,250 129,250 129,250 129,250 129,250 129,250 129,250
114,000 114,000 114,000 114,000 091,000 099,000 100,000 094,000 114,000 114,000 114,000 114,000 114,000 114,000 114,000 093,000 104,000 104,000 104,000 104,000 104,000 104,000 104,000 098,000 143,250 126,250 126,250 126,250 126,250 126,250 126,250 126,250 126,250 126,250 126,250 120,250 129,250 129,250 129,250 129,250 129,250 129,250 129,250 129,250 129,250 129,250 129,250 129,250 129,250 129,250
114,000 114,000 114,000 091,000 099,000 104,000 104,000 100,000 094,000 114,000 114,000 114,000 114,000 114,000 114,000 093,000 104,000 104,000 104,000 104,000 104,000 104,000 104,000 100,000 095,000 095,000 095,000 095,000 095,000 095,000 095,000 095,000 095,043 095,043 094,250 142,250 129,250 129,250 129,250 129,250 129,250 129,250 129,250 129,250 129,250 129,250 129,250 129,250 129,250 129,250
114,000 114,000 091,000 099,000 104,000 156,000 157,000 104,000 100,000 094,000 114,000 114,000 114,000 114,000 114,000 093,000 104,000 104,000 104,000 104,000 104,000 104,000 104,000 104,000 104,000 104,000 104,000 104,000 104,000 104,000 104,000 104,000 104,000 104,000 098,000 142,250 129,250 129,250 129,250 129,250 129,250 129,250 129,250 129,250 129,250 129,250 129,250 129,250 129,250 129,250
114,000 114,000 092,000 101,000 104,000 158,000 159,000 104,000 102,000 097,000 114,000 114,000 114,000 114,000 114,000 093,000 104,000 104,000 104,000 104,000 104,000 104,000 104,000 104,000 104,000 104,000 104,000 104,000 104,000 104,000 104,000 104,000 104,000 104,000 098,000 142,250 129,250 129,250 129,250 129,250 129,250 129,250 129,250 129,250 129,250 129,250 129,250 129,250 129,250 129,250
114,000 114,000 114,000 092,000 101,000 104,000 104,000 102,000 097,000 114,000 114,000 114,000 114,000 114,000 114,000 093,000 104,000 104,000 104,000 104,000 104,000 104,000 104,000 104,000 104,000 104,000 104,000 104,000 104,000 104,000 104,000 104,000 104,000 104,000 098,000 142,250 129,250 129,250 129,250 129,250 129,250 129,250 129,250 129,250 129,250 129,250 129,250 129,250 129,250 129,250
114,000 114,000 114,000 114,000 092,000 101,000 102,000 097,000 114,000 114,000 114,000 114,000 114,000 114,000 114,000 093,000 104,000 104,000 104,000 104,000 104,000 104,000 104,000 104,000 104,000 104,000 104,000 104,000 104,000 104,000 104,000 104,000 104,000 104,000 098,000 142,250 129,250 129,250 129,250 129,250 129,250 129,250 129,250 129,250 129,250 129,250 129,250 129,250 129,250 129,250
114,000 091,000 095,000 094,000 114,000 092,000 097,000 114,000 091,000 095,000 094,000 114,000 114,000 114,000 114,000 093,000 104,000 104,000 104,000 104,000 104,000 104,000 104,000 104,000 104,000 104,000 104,000 104,000 104,000 104,000 104,000 104,000 104,000 104,000 098,000 142,250 129,250 129,250 129,250 129,250 129,250 129,250 129,250 129,250 129,250 129,250 129,250 129,250 129,250 129,250
091,000 099,000 104,000 100,000 094,000 114,000 114,000 091,000 099,000 104,000 100,000 094,000 114,000 114,000 114,000 093,000 104,000 104,000 104,000 104,000 104,000 104,000 104,000 155,000 104,000 104,000 104,000 104,000 104,000 104,000 104,000 104,000 104,000 104,000 098,000 143,250 126,250 126,250 126,250 126,250 126,250 126,250 126,250 126,250 126,250 126,250 126,250 126,250 126,250 126,250
093,000 104,000 147,000 104,000 098,000 114,000 114,000 093,000 104,000 104,000 104,000 098,000 114,000 114,000 114,000 093,000 104,000 104,000 104,000 104,000 104,000 104,000 104,000 104,000 104,000 104,000 104,000 104,000 104,000 104,000 104,000 104,000 104,000 104,000 098,000 114,000 114,000 114,000 114,000 114,000 114,000 114,000 114,000 114,000 114,000 114,000 114,000 114,000 114,000 114,000
092,000 101,000 104,000 102,000 097,000 114,000 114,000 092,000 101,000 104,000 102,000 097,000 114,000 114,000 114,000 093,000 104,000 104,000 104,000 104,000 104,000 104,000 104,000 104,000 104,000 104,000 104,000 104,000 104,000 104,000 104,000 104,000 104,000 104,000 100,000 095,000 095,000 095,000 095,000 095,000 095,000 095,000 095,000 095,000 095,000 095,000 095,000 095,000 095,000 095,000
114,000 092,000 096,000 097,000 114,000 114,000 114,000 114,000 092,000 096,000 097,000 114,000 114,000 114,000 114,000 093,000 104,000 104,000 104,000 104,000 104,000 104,000 104,000 104,000 104,000 104,000 104,000 104,000 104,000 104,000 104,000 104,000 104,000 104,000 104,000 104,000 104,000 104,000 104,000 104,000 104,000 104,000 104,000 104,000 104,000 104,000 104,000 104,000 104,000 104,000
114,000 114,000 114,000 114,000 150,000 151,000 114,000 114,000 114,000 114,000 114,000 114,000 114,000 114,000 114,000 093,000 104,000 104,000 104,000 104,000 154,000 104,000 104,000 104,000 104,000 104,000 104,000 104,000 104,000 104,000 104,000 104,000 104,000 104,000 104,000 104,000 104,000 104,000 104,000 104,000 104,000 104,000 104,000 104,000 104,000 104,000 104,000 104,000 104,000 104,000
114,000 114,000 114,000 114,000 152,000 153,000 114,000 114,000 114,000 114,000 114,000 114,000 114,000 114,000 114,000 093,000 104,000 104,000 104,000 104,000 104,000 104,000 104,000 104,000 104,000 104,000 104,000 104,000 104,000 104,000 104,000 104,000 104,000 104,000 102,000 096,000 096,000 096,000 096,000 096,000 096,000 096,000 096,000 096,000 096,000 096,000 096,000 096,000 096,000 096,000
114,000 114,000 114,000 114,000 114,000 114,000 114,000 114,000 114,000 114,000 114,000 114,000 114,000 114,000 114,000 092,000 096,000 096,000 096,000 096,000 096,000 096,000 096,000 096,000 096,000 096,000 096,000 096,000 096,000 096,000 096,000 096,000 096,000 096,000 097,000 114,000 114,000 114,000 114,000 114,000 114,000 114,000 114,000 114,000 114,000 114,000 114,000 114,000 114,000 114,000
